61
61
+--+--+--+--+--+--+--+--+--+--+--+--+--+--+--+--+--+--+--+--+--+--+--+--+--+--+--+--+--+--+
         |     |     |              |                 |     |        |           |        |
+--+--+  +--+  +  +  +  +--+--+--+  +  +--+--+  +--+  +  +  +  +--+  +  +--+  +  +  +--+  +
|     |  |     |  |     |  |        |     |     |  |     |  |     |  |     |  |     |     |
+  +  +  +  +--+  +--+--+  +  +  +--+--+--+  +--+  +--+--+  +  +  +  +--+  +  +--+--+  +--+
|  |     |     |  |     |     |  |           |     |     |  |  |  |        |  |     |  |  |
+  +--+--+--+  +  +  +  +--+--+  +  +  +--+--+  +--+  +  +  +  +  +--+--+--+  +  +  +  +  +
|              |     |  |     |  |  |  |     |        |  |     |  |           |  |  |  |  |
+--+  +  +--+--+--+--+  +  +--+  +  +--+  +  +--+--+--+  +--+--+--+  +--+--+--+  +  +  +  +
|  |  |  |           |  |        |     |  |        |     |  |     |  |           |  |     |
+  +  +--+  +  +--+  +  +--+--+--+--+  +  +--+  +  +  +--+  +  +  +  +  +  +--+--+  +--+--+
|  |     |  |  |     |     |              |     |  |  |        |  |  |  |  |              |
+  +  +  +  +  +  +--+--+  +--+--+--+--+--+  +--+--+  +  +--+--+  +  +  +--+  +--+--+--+  +
|  |  |     |  |     |     |        |        |     |           |     |     |           |  |
+  +  +--+  +  +--+--+  +--+  +--+  +  +--+--+  +  +--+  +--+  +--+--+--+  +--+  +  +  +--+
|     |     |  |                 |  |  |  |     |     |     |           |     |  |  |     |
+--+--+  +--+  +  +--+--+--+--+--+  +  +  +  +--+--+  +--+--+--+--+--+  +--+  +  +  +  +  +
|        |     |  |                    |     |        |              |  |     |  |  |  |  |
+  +--+--+  +--+--+  +--+--+--+--+  +--+--+  +  +--+--+  +--+--+--+  +  +  +--+--+  +  +  +
|  |        |                 |     |     |  |     |     |     |     |  |  |        |  |  |
+  +--+--+--+  +--+  +--+--+  +--+  +  +  +  +--+  +  +--+  +  +  +--+  +  +  +--+--+--+  +
|        |  |     |  |        |     |  |     |  |     |  |  |     |  |     |           |  |
+--+--+  +  +--+  +  +--+--+--+  +--+--+  +--+  +--+--+  +  +--+--+  +--+--+--+--+--+  +  +
|     |  |        |  |        |     |     |     |     |  |  |     |        |        |  |  |
+  +  +  +--+--+--+  +  +--+  +  +  +  +--+  +--+--+  +  +  +  +  +--+--+  +  +--+  +--+  +
|  |  |              |     |     |     |  |        |  |        |        |        |        |
+  +  +--+--+--+--+--+--+  +--+--+--+--+  +  +--+  +  +--+--+--+--+--+--+--+  +--+--+--+--+
|  |  |        |                 |        |  |     |     |                 |     |        |
+  +  +  +--+  +--+--+--+  +--+  +  +--+  +  +--+  +--+  +  +--+--+--+--+  +--+  +  +--+  +
|  |  |  |     |           |  |  |     |     |     |  |        |        |        |  |     |
+  +  +  +  +--+  +--+--+  +  +  +--+--+--+--+  +--+  +--+  +  +  +--+  +--+--+--+--+  +--+
|  |     |        |        |  |  |        |     |        |  |  |  |     |           |     |
+  +--+--+--+  +--+  +--+  +  +  +  +--+  +  +--+--+  +--+  +  +--+  +--+  +--+--+  +  +--+
|  |        |     |  |  |     |     |  |     |           |  |        |     |        |     |
+  +  +--+  +--+  +  +  +--+--+--+--+  +--+--+  +--+--+  +  +--+--+--+--+--+  +--+--+--+  +
|  |  |  |  |  |  |  |  |                    |        |     |     |        |  |     |  |  |
+  +  +  +  +  +  +  +  +  +--+--+--+--+  +  +--+--+  +--+  +  +  +  +--+  +  +  +  +  +  +
|     |     |  |  |     |  |     |     |  |  |        |     |  |  |  |     |  |  |  |     |
+--+--+--+--+  +  +--+--+  +  +  +  +  +  +--+  +--+--+  +--+  +  +  +  +--+  +  +  +  +--+
|     |           |     |     |  |  |  |     |        |  |     |  |  |  |        |     |  |
+  +  +--+--+  +--+  +--+--+--+  +  +  +--+  +--+--+  +  +  +--+  +  +  +  +  +--+--+--+  +
|  |  |           |  |        |  |  |  |     |        |     |  |     |     |  |           |
+  +  +  +--+  +  +  +  +--+  +  +  +  +  +--+  +--+--+--+--+  +--+--+--+--+  +  +--+--+  +
|  |  |  |  |  |     |  |     |  |  |     |  |  |        |     |     |        |  |     |  |
+  +  +  +  +  +--+  +  +  +--+  +  +--+--+  +  +--+--+  +  +  +--+  +  +  +--+  +  +  +  +
|  |  |  |     |     |  |  |     |           |     |     |  |     |  |  |        |  |     |
+  +--+  +--+--+  +  +  +  +  +--+  +--+--+--+--+  +  +--+  +--+  +  +  +--+--+--+  +--+--+
|     |  |  |     |     |     |     |           |     |     |     |  |        |     |     |
+--+  +  +  +  +--+--+--+  +--+  +--+  +--+--+  +--+--+--+  +  +--+  +--+--+  +  +--+  +  +
|        |     |        |  |           |     |           |  |     |  |     |  |     |  |  |
+  +--+--+--+--+  +--+  +  +  +  +--+--+  +  +--+--+--+  +  +--+  +  +  +  +--+--+  +--+  +
|     |     |     |  |     |  |           |        |     |     |     |  |        |        |
+--+  +  +  +  +--+  +--+--+  +--+  +--+--+--+--+--+  +--+--+  +--+--+  +--+  +  +--+  +--+
|     |  |  |        |     |     |  |        |           |     |     |  |     |     |     |
+  +--+  +  +--+--+--+  +--+  +--+  +  +--+  +  +  +--+--+  +--+  +  +  +--+--+--+  +--+  +
|     |  |     |     |     |     |  |     |  |  |  |           |  |  |  |     |  |  |  |  |
+--+  +  +--+--+  +  +--+  +  +  +--+--+  +--+  +--+  +--+--+  +  +--+  +  +  +  +  +  +  +
|  |  |  |        |     |  |  |           |     |     |        |     |     |  |  |     |  |
+  +  +  +  +  +--+--+  +  +--+  +--+--+  +  +--+  +--+  +--+  +  +  +--+--+  +  +  +  +  +
|     |     |        |           |        |        |     |     |  |           |     |
+--+--+--+--+--+--+--+--+--+--+--+--+--+--+--+--+--+--+--+--+--+--+--+--+--+--+--+--+--+--+
