81
81
+-+-+-+-+-+-+-+-+-+-+-+-+-+-+-+-+-+-+-+-+-+-+-+-+-+-+-+-+-+-+-+-+-+-+-+-+-+-+-+-+
  |       |     |                       |     | |   |     |   |   |       |     |
+ + +-+-+ +-+ + + + +-+-+-+-+-+-+-+-+-+ + +-+ + + + +-+-+ +-+ + + +-+ + + + +-+-+
| | |   | |   |   |   |       |     |   |   |   | |           | |     | |       |
+ + + + + + +-+-+-+-+-+ +-+ +-+ +-+ + +-+-+ +-+ + +-+-+-+ +-+ + +-+-+-+ +-+-+-+ +
|   | |   | |           | |     |         | |   | |   |   | | | |     | |       |
+-+-+ +-+ + +-+-+-+-+-+ + +-+-+-+ + +-+-+-+ + +-+ + + +-+-+ + +-+ +-+ + +-+-+-+-+
|     |   | |     |     |   |     |   |   | |     | |       |   | |   |         |
+ +-+-+-+-+ + +-+ + +-+-+-+ + +-+-+ + + + + +-+-+-+ +-+-+-+ + + + +-+-+-+-+-+-+ +
|           | |   |   |   |   | |   |   | |     |   |   |     | |   |         | |
+-+-+-+ +-+ + + +-+-+-+ + +-+-+ + +-+-+ + + +-+ + +-+-+ +-+-+ + +-+ + +-+ +-+ + +
|     |   |   | |       | |     | |     |     | | |   |     | |     |   | |     |
+ +-+ +-+-+-+-+ + +-+-+-+ + +-+-+ + +-+-+-+-+-+ + + + +-+-+ + +-+-+-+-+ + + +-+-+
|   |     | |   | | |     |     | |     |       |   |       |   |   |   | |     |
+-+ +-+-+ + + +-+ + + +-+-+-+-+ + +-+-+-+ +-+-+-+-+-+-+-+ +-+-+ + +-+ +-+ +-+-+ +
|   |   |     | | | |   | |   |       |   |   |   |   |   |   |   |   |   |     |
+ +-+-+ +-+-+-+ + + +-+ + + + +-+-+-+-+ +-+-+ + + + + + +-+ + +-+-+ +-+ +-+ +-+-+
| |       |     |   |   |   |         |   |   | | | | |     |       | | |   |   |
+ + +-+ + + + +-+-+-+ +-+-+-+-+-+ +-+ +-+ + +-+ + + + +-+-+-+-+-+-+-+ + + +-+-+ +
|   |   |   | | |   |     |     |   |     | |   | | | |     |           |   |   |
+-+-+ +-+-+-+ + + +-+-+-+ + +-+ +-+ +-+-+-+ +-+-+ + +-+ +-+ + +-+-+-+ +-+ +-+ + +
|   | |     | |         |     |     |           |       | |   |   |   |   |   | |
+ + + + +-+ + +-+-+-+-+ +-+-+ +-+-+-+ +-+-+-+-+ +-+ +-+-+ +-+-+ + + +-+ +-+ +-+-+
| |     | | | |       |       |     |         |   | |     |   | | | | | |   |   |
+ +-+-+-+ + + + +-+-+ +-+ +-+-+ +-+ + +-+-+-+ +-+ + + +-+-+ + + +-+ + + +-+ +-+ +
| |     |   |   |     |   |   |   | | |       | | |   |   | | |   | | |   | |   |
+-+ +-+ +-+-+-+-+ +-+-+-+-+ + + +-+ + + +-+ +-+ + + + + + + +-+-+ + + +-+ + + +-+
|     |     |     |     |   | |   | | |   |     |   | | |       |   | |   | | | |
+ + + +-+ + +-+-+ +-+-+ + + + +-+ + + +-+ +-+-+-+-+-+ + +-+-+-+ + +-+ + + + + + +
| | |   | |       |   | | | | | | | |   |   |       | | |     | |   |   |     | |
+ + +-+ +-+-+-+-+-+ + + + +-+ + + + +-+-+-+ + +-+-+ + + +-+ + +-+-+ +-+-+ + +-+ +
| |   |       |     |   | |   | | |       |   |     | |     |   |   |   | | |   |
+ +-+-+-+-+-+ + +-+-+-+-+-+ +-+ + +-+-+-+ +-+-+ +-+-+ +-+-+-+-+ + +-+ + +-+ + + +
|           |   | |   |     |   | |     | |     |   |   |   |     |   | |   | | |
+-+-+-+-+-+ +-+-+ + + +-+ +-+-+ + + +-+ + + +-+-+ +-+-+ +-+ + + +-+-+ + + + + +-+
|   |     |   |     | |   |     |   |   |   |     |     |   | |   |   | | | |   |
+ +-+ +-+ +-+ + + +-+ + +-+ +-+-+-+-+-+ +-+-+ +-+-+ +-+-+ +-+ +-+-+ +-+-+ + + + +
|       |     | | |   |   | | |   |   | |   |     | |   |   | | |         | | | |
+-+ +-+-+-+-+-+ + + +-+-+ + + + + + + + +-+ +-+-+ + +-+ +-+ + + + +-+-+-+ +-+ + +
| |       |     | | |   | | |   | | | |     |   |       | | |   |     | |     | |
+ + +-+-+ + +-+-+ +-+ + + + + +-+ +-+ +-+-+-+-+ +-+ +-+-+ + +-+-+-+-+ + +-+ +-+ +
| | |   | | |     |   |   | |   |   |     |     |     | | |           |     |   |
+ +-+ + + + + +-+-+ +-+-+-+ +-+-+-+ +-+-+ + +-+-+ +-+ + + +-+-+-+-+-+-+-+-+-+ +-+
| |   | |   | |   | |       |       | |       |   |   | |     |               | |
+ + +-+-+-+-+ +-+ + + +-+-+-+ + +-+-+ + +-+-+ + +-+ +-+ +-+ + +-+ +-+-+-+-+-+-+ +
| | |         |   | | |   |   | |     |     |   |   |       |     |   |   |     |
+ + + +-+ +-+-+ +-+ + + + + +-+ + +-+-+-+-+ +-+-+ +-+ +-+-+ +-+-+-+ + + + + + +-+
|   | | |       |   | | |   |   |     |   | |       |     | |   |   |   |   | | |
+-+ + + +-+-+-+-+ +-+ + +-+-+ +-+-+-+ + + + + +-+-+-+-+-+ +-+ + + + +-+-+-+-+ + +
|     |   |       |   | |   |   |       |   | |       |   |   |   |     |       |
+ + +-+-+ + +-+-+-+ + + +-+ +-+ + +-+-+-+-+-+ + +-+-+ +-+-+ +-+-+-+-+-+ + +-+ + +
| |   |   |       | | | |   |   | |   |   | |   |   | |     |           | |   | |
+ +-+ + +-+-+-+-+ +-+ + + +-+-+-+ + + +-+ + +-+-+ +-+ + +-+-+ +-+-+-+-+-+ +-+-+-+
| |     |   |     |   | | |   |   | | |   |     |   |   |   |     |   |   |     |
+ +-+-+-+ + + +-+-+ +-+ + + + + +-+-+ + +-+ + +-+ + +-+-+ + +-+-+ +-+ + +-+ +-+ +
| |   | | | | |     | | | | | |       |     |   | | |     | |     |   |     |   |
+ + + + + +-+ + + +-+ + + + + +-+ +-+-+-+-+-+-+ +-+ + +-+-+ +-+ +-+ +-+-+-+-+ +-+
|   |   | |     |   |   |   | |   |     |       |   | |   |         |       | | |
+-+-+-+ + + + +-+-+ +-+ +-+-+ + +-+ +-+ + +-+ +-+ +-+ +-+ +-+-+-+-+-+ +-+-+ + + +
|     |     | |     | | |     | |   |   | |   |   |   |   |   |     | |   |   | |
+ +-+-+-+-+-+ + +-+-+ + + +-+-+ + +-+ +-+-+ +-+ +-+ + + +-+ + + +-+ + + + +-+-+ +
| |   |       |   |     |   |   | |   |   | |   |   | | |   |   | | |   |     | |
+ + + + +-+-+-+-+-+ + + +-+ + +-+ + +-+ + + +-+ + +-+-+ + +-+-+-+ + +-+-+-+-+ + +
| | |       |   |   | |   | |     |     |   |   | |   |   |     | |         | | |
+ + +-+ +-+ + + + +-+-+-+-+ +-+ +-+-+-+-+-+-+ +-+ + + + +-+ +-+ + +-+-+-+-+ + + +
| |   | | | | | |   |   |   |   |   |       | |   | |   |     |             | | |
+ +-+ + + + + + +-+ + + + +-+ +-+-+ + +-+-+ + + +-+ +-+-+ +-+-+-+ +-+-+-+-+-+ + +
| |   |   |   |   | | |   |   |   |   |     | |     |   | |     |   |     |   | |
+ + +-+-+-+-+-+-+ + + +-+-+ +-+-+ +-+-+ +-+ + +-+-+-+ + +-+ +-+ +-+ + +-+-+ +-+ +
|             | | | | |     |           | |       |   |     | |     |     |   | |
+-+ +-+-+ +-+ + + + + + +-+ + +-+ +-+-+-+ +-+ +-+ + +-+-+-+-+ +-+-+-+-+-+ +-+ + +
|     | | | | |     | |   | |   |   |   |       | |         |   |     |     |   |
+ +-+ + + + + +-+-+-+ +-+-+ + +-+-+ + +-+-+-+-+ + +-+ +-+ +-+-+ + +-+ +-+-+ +-+-+
|   | | |   |           |   |   | | |   |     | |   |   |   |   |   | |   |   | |
+-+ + + +-+ +-+-+ +-+-+-+ +-+-+ + + +-+ +-+ + +-+-+ +-+ + + +-+ +-+-+ + + + + + +
|   | |   | |   |   |     |   |   | |     | |     |   | | |           | | | | | |
+ +-+-+ + + + + +-+ +-+-+-+ + +-+-+ +-+-+ + +-+-+ +-+ + +-+-+-+ +-+-+-+-+ + + + +
|   |   | | | |     |       |         |   |     | |   | |       |           | | |
+-+ + +-+-+ + +-+-+-+ +-+-+-+-+-+-+ + + +-+-+ + +-+ +-+ + +-+-+-+-+-+-+-+ + + + +
|   |       |         |             |   |     |     |   |                 | |
+-+-+-+-+-+-+-+-+-+-+-+-+-+-+-+-+-+-+-+-+-+-+-+-+-+-+-+-+-+-+-+-+-+-+-+-+-+-+-+-+
